###################
#                 #
#                 #
#                 #
#                 #
#                 #
#                 #
#                 #
#                 #
#     TBBBH   F   #
#                 #
#                 #
#                 #
#                 #
#                 #
#                 #
#                 #
#                 #
###################|
