###################
#  F   F   F   F  #
# ##### # # ##### #
#F   F  # #  F   F#
# ### ### ### ### #
# # #  F   F  # # #
# ### ####### ### #
#F   F       F   F#
### #####F##### ###
#    F       F    #
# ####### ####### #
#  F    # #    F  #
# ##### # # ##### #
#     #  F  #     #
#F# #F#F# #F#F# #F#
# # #   # #   # # #
#F# ##### ##### #F#
#      TBBBH      #
###################|
