###################
#  F   F   F   F  #
# ### # ### # ### #
#F# #F#     #F# #F#
# ### # # # # ### #
#     #F# #F#     #
# ##### # # ##### #
#F#  F       F  #F#
# # #####F##### # #
#    F       F    #
# ##### ### ##### #
#  F    # #    F  #
# ### # ### # ### #
# # # #  F  # # # #
#F###F#F###F#F###F#
#     # # # #     #
#F##### ### #####F#
#      BBBBH      #
###################